



11111111111111111111
1P000000000000000001
10000C00000000000001
100000X00C0000000001
10000000000000X00001
10000000000C000000E1
11111111111111111111





