


11111111111111111111
1E000000000000000001
10000C00000000000001
100000000C0000000001
10000000000000000001
100000000000000000P1
11111111111111111111





